3,3,3,3,3,0,0,0,0,0,0,0,0,0,0,0,0,0,0,0,0,0,0,0,0,0,3,3
6,6,6,6,6,0,0,0,0,0,0,0,0,0,0,0,0,0,0,0,0,0,0,0,0,0,6,6
6,6,6,6,6,0,0,0,7,0,0,0,0,0,0,0,0,0,7,0,0,0,0,0,0,0,6,6
6,6,6,6,6,0,0,2,3,4,0,0,0,0,0,0,0,2,3,4,0,0,3,0,0,0,6,6
6,6,6,6,6,0,3,0,0,0,0,0,0,0,0,0,0,0,0,0,0,0,0,0,3,0,6,6
6,6,6,6,6,0,0,0,0,0,0,3,3,0,0,0,0,0,0,0,5,5,0,0,0,0,6,6
6,6,6,6,6,3,3,3,2,0,0,0,0,0,0,0,0,3,0,0,6,6,0,3,0,0,6,6
6,6,6,6,6,0,0,0,6,0,0,7,0,0,0,0,3,0,0,0,0,7,0,0,0,0,6,6
6,6,6,6,6,0,0,0,0,0,0,6,0,0,0,3,6,0,0,0,0,0,0,0,3,0,6,6
6,6,6,6,6,0,1,0,0,0,0,0,0,0,0,6,6,0,7,0,0,0,0,0,0,0,6,6
6,6,6,6,6,3,3,3,0,3,4,0,0,2,3,3,3,3,3,3,3,4,0,0,2,3,6,6
6,6,6,6,6,6,6,6,5,6,6,5,5,6,6,6,6,6,6,6,6,6,5,5,6,6,6,6
6,6,6,6,6,6,6,6,6,6,6,6,6,6,6,6,6,6,6,6,6,6,6,6,6,6,6,6